Temple of Tomorrow
An Interactive Fiction by Falchion776
Release 1 / Serial number 240306 / Inform 7 build 6M62 (I6/v6.33 lib 6/12N) SD

Inn
Having arrived late in town last night, today is your first day to explore the village of Eastridge and find out more about the Temple of Tomorrow. The Professor did not give you a specific location so from this point on its up to you to locate the temple and recover the Binding Shield. You find yourself on the steps of the Eastridge's inn. It's an unremarkable building starting to fall into disarry. From here you can see almost the entire village as most of Eastridge is contained on a single road. The Bar is inside. To the North is the General Store. To the South is the Farmer's Market.

>n
General Store
The largest building in town. From the windows you can see cluttered rows of various tools, farming supplies, and simple goods. You're not sure if there will be anything useful to you unless you check inside.  The Store Counter is inside. To the North is the North Roadway. To the South is the Inn.

>s
Inn
You find yourself on the steps of the Eastridge's inn. It's an unremarkable building starting to fall into disarry. From here you can see almost the entire village as most of Eastridge is contained on a single road. To the North is the General Store. To the South is the Farmer's Market.

>s
Farmer's Market
DESCRIPTION

>n
Inn
You find yourself on the steps of the Eastridge's inn. Having arrived late in town last night today is your first day to explore the village and find out more about the Temple of Tomorrow. The Professor did not give you a specific location so from this point on its up to you to locate the temple and recover the Binding Shield.

Most of Eastridge is contained on a single road. To the North is the General Store. To the South is the Farmer's Market.

>end
That's not a verb I recognise.

>quit
Are you sure you want to quit?

* * *

>s
Farmer's Market
DESCRIPTION

>s
Village Gates
DESCRIPTION

>s
Old Roadway
DESCRIPTION

>w
Sunset Swamp
DESCRIPTION

>w
You can't go that way.

>n
You can't go that way.

>s
You can't go that way.

>e
Old Roadway
DESCRIPTION

>n
Village Gates
DESCRIPTION

>n
Farmer's Market
DESCRIPTION

>n
Inn
You find yourself on the steps of the Eastridge's inn. Having arrived late in town last night today is your first day to explore the village and find out more about the Temple of Tomorrow. The Professor did not give you a specific location so from this point on its up to you to locate the temple and recover the Binding Shield.

Most of Eastridge is contained on a single road. To the North is the General Store. To the South is the Farmer's Market.

* * *

>n
General Store
The largest building in town. From the windows you can see cluttered rows of various tools, farming supplies, and simple goods. You're not sure if there will be anything useful to you unless you check inside.  The Store Counter is inside. To the North is the North Roadway. To the South is the Inn.

>n
North Roadway
As you step out beyond the walls of village you come to a realization. With each step you take you get closer and closer to Rema, the old imperial capital. No dubt the ruins are crawling with member of the Horde, but still, you can't help but shake off the feeling nostalgia. To the East is the Forest of Vandor. To the South is the General Store.

>e
Forest of Vandor
Stepping off the road you enter the treeline and with it the mystical forest of Vandor. Quickly the light of the day fades as the dense canopy envlopes you. There is no trail to follow, just your instincts. Breifly you pause, considering all the tall tales you've heard of otherworldly creatures that stalk the brush, strange lights and shapes that trap lost hunters, and mysterious and often cruel fey that are rumored to live at the heart of the forest. You shake off your fears, this close to the edge of the woods you shouldn't run into anything too unusual, but just in case you begin to walk ever so slightly faster. All around you is an endless vista of oak and pine.

>w
North Roadway
As you step out beyond the walls of village you come to a realization. With each step you take you get closer and closer to Rema, the old imperial capital. No dubt the ruins are crawling with member of the Horde, but still, you can't help but shake off the feeling nostalgia. To the East is the Forest of Vandor. To the South is the General Store.

>e
Forest of Vandor
Stepping off the road you enter the treeline and with it the mystical forest of Vandor. Quickly the light of the day fades as the dense canopy envlopes you. There is no trail to follow, just your instincts. All around you is an endless vista of oak and pine.

* * *

>n
North Roadway
As you step out beyond the walls of village you come to a realization. With each step you take you get closer and closer to Rema, the old imperial capital. No dubt the ruins are crawling with member of the Horde, but still, you can't help but shake off the feeling nostalgia. To the East is the Forest of Vandor. To the South is the General Store.

>n
You can't go that way.

>w
You can't go that way.

>e
Forest of Vandor
Stepping off the road you enter the treeline and with it the mystical forest of Vandor. Quickly the light of the day fades as the dense canopy envlopes you. There is no trail to follow, just your instincts. Breifly you pause, considering all the tall tales you've heard of otherworldly creatures that stalk the brush, strange lights and shapes that trap lost hunters, and mysterious and often cruel fey that are rumored to live at the heart of the forest. You shake off your fears, this close to the edge of the woods you shouldn't run into anything too unusual, but just in case you begin to walk ever so slightly faster. All around you is an endless vista of oak and pine.

>ne
Temple Exterior
You your march through the forest continues, you finaly spot a clearing. Dashing forward you come across old foundations and ruins of what you assume to be a town. As you navigate your way around the ruins you come to one building still standing. It appears to be a simple one level story building with a church-like aesthetic, but without the stained glass windows or tall towers that you would normally see on a church. This is it. This is the Temple of Tomorrow.

* * *

>north
General Store
The largest building in town. From the windows you can see cluttered rows of various tools, farming supplies, and simple goods. You're not sure if there will be anything useful to you unless you check inside.  The Store Counter is inside. To the North is the North Roadway. To the South is the Inn.

* * *

>in
Bar
The Bar is empty. Despite your early start, the Bar remains absent of locals. Only the barkeep, Renford Gerard, remains. Chairs remain on top of the tables and bar itself looks freshly cleaned. Your Private Room is upstaris. The rest of the town is outside.

You can see Renford Gerard here.

The barkeep watches you while cleaning a few dirty dishes.

>out
Inn
You find yourself on the steps of the Eastridge's inn. It's an unremarkable building starting to fall into disarry. From here you can see almost the entire village as most of Eastridge is contained on a single road. The Bar is inside. To the North is the General Store. To the South is the Farmer's Market.

>in
Bar
The Bar is empty. Despite your early start, the Bar remains absent of locals. Only the barkeep, Renford Gerard, remains. Chairs remain on top of the tables and bar itself looks freshly cleaned. Your Private Room is upstaris. The rest of the town is outside.

You can see Renford Gerard here.

The barkeep watches you while cleaning a few dirty dishes.

* * *

>out
Inn
You find yourself on the steps of the Eastridge's inn. It's an unremarkable building starting to fall into disarry. From here you can see almost the entire village as most of Eastridge is contained on a single road. The Bar is inside. To the North is the General Store. To the South is the Farmer's Market.

>n
General Store
The largest building in town. From the windows you can see cluttered rows of various tools, farming supplies, and simple goods. You're not sure if there will be anything useful to you unless you check inside.  The Store Counter is inside. To the North is the North Roadway. To the South is the Inn.

>in
Store Counter
DESCRIPTION

You can see Ilbert Drogo here.

The shopkeep smirks at you and says: "What are you buyin"?"

>out
General Store
The largest building in town. From the windows you can see cluttered rows of various tools, farming supplies, and simple goods.  The Store Counter is inside. To the North is the North Roadway. To the South is the Inn.

>s
Inn
You find yourself on the steps of the Eastridge's inn. It's an unremarkable building starting to fall into disarry. From here you can see almost the entire village as most of Eastridge is contained on a single road. The Bar is inside. To the North is the General Store. To the South is the Farmer's Market.

>s
Farmer's Market
A score of stalls line the road. Despite being the busiest part of town, only a dozen people mill about the market. The energy is low, but in a relaxed war of people just going about their everyday. 

You can see Crazy Joe here.

Glancing around the market you spot a lone stall selling peaches. As you lock eyes with the vendor you meet a soul that has gone mad.

>s
Village Gates
The Village Gates are simple wooden structures more for keeping wild animals at bay than bandits or the Horde. Oaken walls extend from either side encompassing the village. The only other object of intrest here is an old stonearchway 

You can see Beyton Betan here.

The Captain of the Guard is currently standing watch. You can feel his glaze following you.

>s
South Roadway
From the outisde, the village is nothing impressive, seemingly just another town in what should be a long line of farmering towns. However, thanks to the Horde, this town is the farthest north settlement still in existence. The closest town, Cereshold, is nearly a week long journey back south. And though you wish to return to cilvilzation you still have work to do here. To the North is the Village Gates. To the West is Sunset Swamp.

>w
Sunset Swamp
As you leave the town and enter into the swamp the smell, unnoticeable from inside the town walls, hits your nostrils and makes you pause for a moment before you recover and continue on. The bugs start to swarm you as plunge deeper into the dense folege and slimy muck.

>w
Small Pond
Navigating your way through the mysterious swamp you come upon a small hut. It's an old wooden strcutre, built over a small pond and hoisted above the water by stilts. It's close enough to the edge of the swamp that with a few simple hops across the swamp you can make it to the hut. The Witch's Hut is Inside. To the East is Sunset Swamp.

>in
Witch's Hut
As you enter the hut it takes a moment for your eyes to adjust to the darkness. You find a cluttered, homey space. In the center of the hut is a large, black, cauldron currently cold and empty. The walls of the hut are covered with shelves of knick knacks and what seem to be spell ingredients.

You can see Maeve Greenwood here.

From out of the darkness off the corner a old dragonborn woman leans forward in her chair and slash you a toothy grin.

* * *

>s
Farmer's Market
A score of stalls line the road. Despite being the busiest part of town, only a dozen people mill about the market. The energy is low, but in a relaxed war of people just going about their everyday. 

You can see Crazy Joe here.

Glancing around the market you spot a lone stall selling peaches. As you lock eyes with the vendor you meet a soul that has gone mad.

* * *

>s
South Roadway
From the outisde, the village is nothing impressive, seemingly just another town in what should be a long line of farmering towns. However, thanks to the Horde, this town is the farthest north settlement still in existence. The closest town, Cereshold, is nearly a week long journey back south. And though you wish to return to cilvilzation you still have work to do here. To the North is the Village Gates. To the West is Sunset Swamp.

>s
You can't go that way.

>w
Sunset Swamp
As you leave the town and enter into the swamp the smell, unnoticeable from inside the town walls, hits your nostrils and makes you pause for a moment before you recover and continue on. The bugs start to swarm you as plunge deeper into the dense folege and slimy muck.

* * *

>w
Small Pond
Navigating your way through the mysterious swamp you come upon a small hut. It's an old wooden strcutre, built over a small pond and hoisted above the water by stilts. It's close enough to the edge of the swamp that with a few simple hops across the swamp you can make it to the hut. The Witch's Hut is Inside. To the East is Sunset Swamp.

>w
You can't go that way.

>i
You are carrying nothing.

>in
Witch's Hut
DESCRIPTION

>out
Small Pond
Navigating your way through the mysterious swamp you come upon a small hut. It's an old wooden strcutre, built over a small pond and hoisted above the water by stilts. It's close enough to the edge of the swamp that with a few simple hops across the swamp you can make it to the hut. The Witch's Hut is Inside. To the East is Sunset Swamp.

>inventory
You are carrying nothing.

* * *

>w
You can't go that way.

>in
Witch's Hut
As you enter the hut it takes a moment for your eyes to adjust to the darkness. You find a cluttered, homey space. In the center of the hut is a large, black, cauldron currently cold and empty. The walls of the hut are covered with shelves of knick knacks and what seem to be spell ingredients.

You can see the Witch here.

From out of the darkness off the corner a old dragonborn woman leans forward in her chair and slash you a toothy grin.

>look
Witch's Hut
As you enter the hut it takes a moment for your eyes to adjust to the darkness. You find a cluttered, homey space. In the center of the hut is a large, black, cauldron currently cold and empty. The walls of the hut are covered with shelves of knick knacks and what seem to be spell ingredients.

You can see the Witch here.

From out of the darkness off the corner a old dragonborn woman leans forward in her chair and slash you a toothy grin.

>look witch
You peer at the Witch a bit more closely and realize that it's Maeve Greenwood.

From out of the darkness off the corner a old dragonborn woman leans forward in her chair and slash you a toothy grin.

>look
Witch's Hut
As you enter the hut it takes a moment for your eyes to adjust to the darkness. You find a cluttered, homey space. In the center of the hut is a large, black, cauldron currently cold and empty. The walls of the hut are covered with shelves of knick knacks and what seem to be spell ingredients.

You can see Maeve Greenwood here.

From out of the darkness off the corner a old dragonborn woman leans forward in her chair and slash you a toothy grin.

* * *

>w
You can't go that way.

>in
Witch's Hut
As you enter the hut it takes a moment for your eyes to adjust to the darkness. You find a cluttered, homey space. In the center of the hut is a large, black, cauldron currently cold and empty. The walls of the hut are covered with shelves of knick knacks and what seem to be spell ingredients.

You can see Maeve Greenwood here.

From out of the darkness off the corner a old dragonborn woman leans forward in her chair and slash you a toothy grin.

>look
Witch's Hut
As you enter the hut it takes a moment for your eyes to adjust to the darkness. You find a cluttered, homey space. In the center of the hut is a large, black, cauldron currently cold and empty. The walls of the hut are covered with shelves of knick knacks and what seem to be spell ingredients.

You can see Maeve Greenwood here.

From out of the darkness off the corner a old dragonborn woman leans forward in her chair and slash you a toothy grin.

* * *

>s
Farmer's Market
A score of stalls line the road. Despite being the busiest part of town, only a dozen people mill about the market. The energy is low, but in a relaxed war of people just going about their everyday. 

You can see Crazy Joe here.

Glancing around the market you spot a lone stall selling peaches. As you lock eyes with the vendor you meet a soul that has gone mad.

>buy orange
Crazy Joe cackled with delight at his shiny new coin.

Glancing around the market you spot a lone stall selling peaches. As you lock eyes with the vendor you meet a soul that has gone mad.

>i
You are carrying:
  an Orange
  cloak (being worn)
  coin purse
    10 gold coins

Glancing around the market you spot a lone stall selling peaches. As you lock eyes with the vendor you meet a soul that has gone mad.

* * *

>l
Inn
You find yourself on the steps of the Eastridge's inn. It's an unremarkable building starting to fall into disarry. From here you can see almost the entire village as most of Eastridge is contained on a single road. The Bar is inside. To the North is the General Store. To the South is the Farmer's Market.

>look
Inn
You find yourself on the steps of the Eastridge's inn. It's an unremarkable building starting to fall into disarry. From here you can see almost the entire village as most of Eastridge is contained on a single road. The Bar is inside. To the North is the General Store. To the South is the Farmer's Market.

* * *

>i
You are carrying:
  cloak (being worn)
  coin purse
    ten golds

>w
You can't go that way.

>look me
As good-looking as ever.

>look i
You can't see any such thing.

>look cloack
You can't see any such thing.

>look cloak
You can't see any such thing.

>cloak
That's not a verb I recognise.

>i
You are carrying:
  a coin purse
    Ten gold

>wear
(the coin purse)
You can't wear that!

* * *

>i
You are carrying:
  cloak (being worn)
  coin purse
    ten golds

>take off cloak
You take off A cloak.

>put on cloak
You put on A cloak.

>inspect cloak
That's not a verb I recognise.

>look cloak
Your old travelling cloak. It has served you well for many years.

>look coin purse
A new coin sack the Professor gave you for your expidition.

In A coin purse is 10 gold.

* * *

>i
You are carrying:
  cloak (being worn)
  coin purse
    ten golds

>look cloak
Your old travelling cloak. It has served you well for many years.

>look coin purse
A new coin sack the Professor gave you for your expidition.

In coin purse is 10 gold.

* * *

>i
You are carrying:
  cloak (being worn)
  coin purse
    ten golds

>s
Farmer's Market
A score of stalls line the road. Despite being the busiest part of town, only a dozen people mill about the market. The energy is low, but in a relaxed war of people just going about their everyday. 

You can see Crazy Joe here.

Glancing around the market you spot a lone stall selling peaches. As you lock eyes with the vendor you meet a soul that has gone mad.

>buy orange
You have no money.

Glancing around the market you spot a lone stall selling peaches. As you lock eyes with the vendor you meet a soul that has gone mad.

>take out gold coin
I only understood you as far as wanting to take outside.

>take gold coin
Taken.

Glancing around the market you spot a lone stall selling peaches. As you lock eyes with the vendor you meet a soul that has gone mad.

>i
You are carrying:
  10 gold coin
  cloak (being worn)
  coin purse

Glancing around the market you spot a lone stall selling peaches. As you lock eyes with the vendor you meet a soul that has gone mad.

>buy orange
Crazy Joe cackled with delight at his shiny new coin.

Glancing around the market you spot a lone stall selling peaches. As you lock eyes with the vendor you meet a soul that has gone mad.

>i
You are carrying:
  an Orange
  cloak (being worn)
  coin purse

Glancing around the market you spot a lone stall selling peaches. As you lock eyes with the vendor you meet a soul that has gone mad.

* * *

>i
You are carrying:
  cloak (being worn)
  coin purse
    ten golds

>take coin
(the gold coin)
Taken.

>s
Farmer's Market
A score of stalls line the road. Despite being the busiest part of town, only a dozen people mill about the market. The energy is low, but in a relaxed war of people just going about their everyday. 

You can see Crazy Joe here.

Glancing around the market you spot a lone stall selling peaches. As you lock eyes with the vendor you meet a soul that has gone mad.

>i
You are carrying:
  a gold coin
  cloak (being worn)
  coin purse

Glancing around the market you spot a lone stall selling peaches. As you lock eyes with the vendor you meet a soul that has gone mad.

>buy ornage
You can't see any such thing.

>buy orange
Crazy Joe cackled with delight at his shiny new coin.

Glancing around the market you spot a lone stall selling peaches. As you lock eyes with the vendor you meet a soul that has gone mad.

* * *

>take coin
(the gold coin)
Taken.

>i
You are carrying:
  a gold coin
  cloak (being worn)
  coin purse

>s
Farmer's Market
A score of stalls line the road. Despite being the busiest part of town, only a dozen people mill about the market. The energy is low, but in a relaxed war of people just going about their everyday. 

You can see Crazy Joe here.

Glancing around the market you spot a lone stall selling peaches. As you lock eyes with the vendor you meet a soul that has gone mad.

>buy peach
Crazy Joe cackled with delight at his shiny new coin.

Glancing around the market you spot a lone stall selling peaches. As you lock eyes with the vendor you meet a soul that has gone mad.

>i
You are carrying:
  a Peach
  cloak (being worn)
  coin purse

Glancing around the market you spot a lone stall selling peaches. As you lock eyes with the vendor you meet a soul that has gone mad.

* * *

>i
You are carrying:
  cloak (being worn)
  coin purse
    ten golds

>take gold
Taken.

>i
You are carrying:
  a gold
  cloak (being worn)
  coin purse
    nine golds

* * *

I beg your pardon?

>i
You are carrying:
  cloak (being worn)
  coin purse
    ten Gold Coins

>take gold con
You can't see any such thing.

>take gold coin
Taken.

>i
You are carrying:
  a Gold Coin
  cloak (being worn)
  coin purse
    nine Gold Coins